#########################
#.   {  .  ..... ....M..#
#       .  .............#
#.######.........######.#
  #    #.### ###.#    #. 
 .#    #.#     #.#    #. 
#.######.#######.######.#
#.......................#
#########################
